1111111111111111111
1000000000C000000E1
1000001111000001101
100000C000000000001
1111111111000011111

1111111111111111111