111111111
1E00000C1
1000P0001

111111111