111111111111111
1E00C0000000001
1000P1110000001
111111111111111