1111111111111
1P00000000001
1011110111101
1C1C0000C1C01
1010111010101
1C000E00000C1
1111111111111
